51
41
2 2 2 2 2 2 2 2 2 2 2 2 2 2 2 2 2 2 2 2 2 2 2 2 2 2 2 2 2 2 2 2 2 2 2 2 2 2 2 2 2 2 2 2 2 2 2 2 2 2 2
2 9 2 9 2 9 2 9 2 9 2 9 2 9 2 9 2 9 2 9 2 9 2 9 2 9 8 9 9 9 9 9 9 9 9 9 9 9 9 9 9 9 9 9 9 9 9 9 9 9 2
2 9 3 9 9 9 9 9 9 9 9 9 9 3 9 9 9 3 9 9 9 9 9 3 9 9 8 9 2 2 2 2 3 3 3 3 2 2 2 2 2 3 3 3 3 2 2 2 2 9 2
2 9 2 9 2 3 2 3 2 3 2 3 2 3 2 9 2 9 2 9 2 9 2 9 2 9 2 9 2 9 9 9 9 9 9 9 9 9 9 9 9 9 9 9 9 9 9 9 2 9 2
2 9 3 9 9 9 3 9 9 9 9 9 9 9 3 9 9 3 9 9 9 9 9 9 9 3 2 9 2 9 3 9 9 9 9 9 9 9 9 9 9 9 9 9 9 9 3 9 2 9 2
2 9 2 9 2 3 2 3 2 3 2 3 2 9 2 9 2 9 2 3 2 9 2 3 2 9 2 9 3 9 9 2 2 2 2 3 3 3 3 3 3 3 2 2 2 2 9 9 3 9 2
2 3 3 9 9 9 3 9 9 9 9 9 9 9 3 9 9 3 9 9 9 3 9 9 9 3 2 9 3 9 9 2 9 9 9 9 9 9 9 9 9 9 9 9 9 2 9 9 3 9 2
2 9 2 9 2 3 2 3 2 3 2 9 2 9 2 3 2 9 2 9 2 9 2 9 2 9 2 9 3 9 9 2 9 3 9 9 9 9 9 9 9 9 9 3 9 2 9 9 3 9 2
2 9 9 9 9 9 9 3 9 9 9 9 9 3 9 9 9 3 9 9 9 9 3 9 9 9 2 9 2 9 9 3 9 9 2 2 2 3 3 3 2 2 2 9 9 3 9 9 2 9 2
2 3 2 3 2 3 2 9 2 9 2 9 2 9 2 9 2 9 2 9 2 9 2 9 2 9 2 9 2 9 9 2 9 9 2 9 9 9 9 9 9 9 2 9 9 2 9 9 2 9 2
2 9 9 9 9 9 9 3 9 3 9 9 3 9 9 3 9 9 3 9 9 3 9 9 9 9 2 9 2 9 9 2 9 9 2 9 9 9 9 9 9 9 2 9 9 2 9 9 2 9 2
2 9 2 9 2 9 2 9 2 3 2 9 2 9 2 9 2 9 2 9 2 9 2 9 2 3 2 9 2 9 9 3 9 9 2 2 2 3 3 3 2 2 2 9 9 3 9 9 2 9 2
2 3 9 9 9 3 9 9 9 3 9 3 9 9 3 9 9 9 9 3 9 9 9 3 9 9 2 9 3 9 9 2 9 3 9 9 9 9 9 9 9 9 9 3 9 2 9 9 3 9 2
2 9 2 3 2 9 2 9 2 9 2 9 2 9 2 9 2 9 2 9 2 9 2 9 2 9 2 9 3 9 9 2 9 9 9 9 9 9 9 9 9 9 9 9 9 2 9 9 3 9 2
2 9 3 9 9 9 9 3 9 9 3 9 9 9 9 3 9 3 9 9 9 3 9 9 9 9 2 9 3 9 9 2 2 2 2 3 3 3 3 3 3 3 2 2 2 2 9 9 3 9 2
2 3 2 9 2 9 2 9 2 3 2 9 2 9 2 9 2 9 2 9 2 9 2 9 2 9 2 9 2 9 3 9 9 9 9 9 9 9 9 9 9 9 9 9 9 9 3 9 2 9 2
2 9 3 9 9 9 3 9 3 9 9 3 9 9 3 9 9 3 9 9 9 9 9 9 9 3 2 9 2 9 9 9 9 9 9 9 9 9 9 9 9 9 9 9 9 9 9 9 2 9 2
2 9 2 9 2 9 2 9 2 9 2 9 2 3 2 9 2 9 2 9 2 9 2 9 2 9 2 9 2 2 2 2 3 3 3 3 2 2 2 2 2 3 3 3 3 2 2 2 2 9 2
2 9 3 9 9 3 9 9 3 9 9 9 9 9 9 3 9 9 3 9 9 3 9 9 9 9 2 9 9 9 9 9 9 9 9 9 9 9 9 9 9 9 9 9 9 9 9 9 9 9 2
2 2 2 2 2 2 2 2 2 2 2 2 2 2 2 2 2 2 2 2 2 2 2 2 2 2 2 2 2 2 2 2 2 2 2 2 2 2 2 2 2 2 2 2 2 2 2 2 8 8 2
2 8 8 9 9 9 9 9 9 9 9 9 9 9 9 9 3 9 9 9 9 9 9 9 9 9 9 9 9 9 9 9 9 9 3 9 9 9 9 9 9 9 9 9 9 9 9 9 8 8 2
2 8 2 2 2 2 9 2 9 9 2 9 9 2 9 9 2 9 9 9 9 9 9 9 9 9 9 9 9 9 9 9 9 9 2 9 9 2 3 9 2 9 9 2 9 2 2 2 2 8 2
2 9 2 8 9 9 9 9 9 9 3 9 9 9 9 9 3 9 9 9 3 3 9 9 9 9 9 9 3 3 9 9 9 9 3 9 9 9 9 9 9 9 9 9 9 9 9 8 2 9 2
2 9 2 9 2 2 2 2 9 2 3 9 2 9 9 2 9 9 9 3 2 2 3 9 9 9 9 3 2 2 3 9 9 9 9 2 9 9 2 3 9 2 9 2 2 2 2 9 2 9 2
2 9 2 9 2 8 9 9 9 9 9 9 3 3 9 3 9 9 9 3 2 2 3 9 9 9 9 3 2 2 3 9 9 9 9 9 3 3 9 9 9 9 3 9 9 8 2 9 2 9 2
2 9 3 9 2 9 2 2 2 2 9 2 3 9 2 9 9 9 9 3 2 2 3 9 9 9 9 3 2 2 3 9 9 9 9 9 2 9 9 2 9 2 2 2 2 9 2 9 9 9 2
2 9 3 9 2 9 2 8 9 9 9 9 9 9 3 9 9 9 9 3 2 2 3 9 9 9 9 3 2 2 3 9 9 9 9 9 3 9 9 9 9 9 9 8 2 9 2 9 9 9 2
2 9 2 3 9 9 2 9 2 2 2 2 9 2 3 9 2 2 9 9 3 3 9 9 2 9 9 9 3 3 9 9 9 2 2 9 3 2 3 2 2 2 2 9 2 9 9 9 3 9 2
2 9 2 3 3 9 2 9 2 8 9 9 9 9 9 9 9 2 2 9 9 9 9 9 2 9 9 9 9 9 9 9 2 2 9 9 9 9 3 9 9 8 2 9 2 9 9 3 2 9 2
2 9 3 9 3 3 9 9 2 9 2 2 2 2 9 9 9 9 2 2 9 9 9 9 2 2 9 9 9 9 9 2 2 9 9 9 9 2 2 2 2 9 2 9 9 3 9 3 9 9 2
2 9 3 9 9 2 9 9 2 9 2 8 9 9 9 9 9 9 9 2 2 9 9 9 9 9 9 9 9 9 2 2 9 9 9 9 9 9 9 8 2 9 2 9 9 2 2 9 9 9 2
2 9 3 9 9 9 3 9 9 9 2 9 2 2 2 2 9 9 9 9 2 2 9 9 9 9 9 9 9 2 2 9 9 9 9 2 2 2 2 9 2 9 9 9 9 9 9 9 9 9 2
2 9 2 9 3 3 3 3 2 9 2 9 2 8 8 9 9 9 9 9 9 2 2 2 9 9 9 2 2 2 9 9 9 9 9 9 8 8 2 9 2 9 3 3 2 9 2 3 2 9 2
2 3 3 9 2 3 2 9 3 3 3 9 2 8 2 2 2 2 9 9 9 9 9 2 2 2 2 2 9 9 9 9 9 2 2 2 2 8 2 9 9 9 3 9 9 9 3 3 9 9 2
2 3 3 9 9 3 9 9 9 2 9 9 2 9 2 8 8 9 9 9 9 9 9 9 9 9 9 9 9 9 9 9 9 9 8 8 2 9 2 9 9 9 2 9 9 2 9 2 9 9 2
2 9 9 9 3 9 9 3 3 9 9 9 9 9 2 8 2 2 2 2 9 9 9 9 9 9 9 9 9 9 9 2 2 2 2 8 2 3 9 9 9 9 9 9 9 9 9 9 9 9 2
2 9 9 9 2 9 2 3 9 3 2 9 2 9 2 9 2 8 8 9 9 9 9 9 9 9 9 9 9 9 9 9 8 8 2 9 2 3 3 9 2 3 9 9 2 9 9 2 9 9 2
2 9 2 9 9 2 9 9 2 9 9 9 2 3 9 9 2 8 2 2 2 2 8 8 8 8 8 8 8 2 2 2 2 8 2 9 9 3 9 9 9 3 9 9 9 9 3 9 9 9 2
2 9 9 9 9 2 2 9 9 9 9 9 9 3 9 9 2 9 2 9 9 9 9 9 9 9 9 9 9 9 9 9 2 9 2 9 9 2 9 9 2 3 3 9 9 3 3 2 9 9 2
2 9 9 9 9 9 9 9 9 9 9 2 9 9 2 9 9 9 2 9 9 9 9 9 9 9 9 9 9 9 9 9 2 9 9 9 9 9 9 9 9 9 9 9 2 9 9 9 9 9 2
2 2 2 2 2 2 2 2 2 2 2 2 2 2 2 2 2 2 2 2 2 2 2 2 2 2 2 2 2 2 2 2 2 2 2 2 2 2 2 2 2 2 2 2 2 2 2 2 2 2 2