30
20
4 4 4 4 4 4 4 4 4 4 4 4 4 4 4 4 4 4 4 4 4 4 4 4 4 4 4 4 4 4
4 9 9 5 9 7 9 4 9 9 9 9 4 9 9 9 9 4 9 9 9 4 9 5 7 9 9 9 9 4
4 9 9 4 4 9 9 9 9 4 9 9 9 5 5 4 9 9 9 4 9 9 9 5 9 4 4 9 9 4
4 5 4 4 9 4 9 4 9 4 9 4 5 4 9 9 4 9 4 9 4 9 4 9 4 9 4 4 9 4
4 9 4 9 9 9 9 9 9 5 9 9 5 9 9 5 5 9 5 9 9 9 9 9 5 5 9 4 9 4
4 7 9 9 9 4 9 4 5 4 9 4 9 4 9 9 4 5 4 5 4 9 4 5 4 9 9 5 7 4
4 9 5 9 9 9 9 9 5 5 9 9 5 5 5 5 9 9 9 5 5 9 5 5 9 9 4 5 9 4
4 4 5 9 9 4 9 4 5 9 9 4 4 4 7 7 4 4 4 9 5 9 4 9 4 5 5 9 9 4
4 4 5 4 9 9 9 9 9 9 9 4 7 5 9 9 5 7 4 9 9 9 9 9 9 9 9 9 4 4
4 9 9 4 9 4 9 4 9 4 9 4 7 9 7 7 9 7 4 9 4 9 4 9 4 9 4 9 9 4
4 9 5 9 9 4 5 4 9 4 5 4 7 9 7 7 9 7 4 5 4 9 4 9 4 5 5 9 9 4
4 4 5 5 9 9 5 5 5 9 9 4 7 5 9 9 5 7 4 9 5 9 9 5 9 9 9 9 4 4
4 9 4 9 4 4 9 4 9 4 9 4 4 4 7 7 4 4 4 9 4 5 4 9 4 9 4 9 9 4
4 9 9 5 5 9 9 9 9 9 9 5 9 9 5 5 9 9 9 5 9 9 9 9 9 9 9 5 5 4
4 7 5 5 9 4 9 4 9 4 9 4 9 4 9 9 4 9 4 9 4 9 4 9 4 5 5 9 7 4
4 9 4 9 9 5 5 9 9 9 5 9 9 5 9 9 9 9 9 5 9 9 9 9 5 5 9 4 9 4
4 9 4 4 9 4 5 4 9 4 9 4 9 4 5 9 4 9 4 9 4 5 4 9 4 9 4 4 9 4
4 9 9 4 4 9 9 9 9 4 9 9 9 5 9 5 4 9 5 9 9 9 9 5 9 4 4 9 9 4
4 9 9 9 9 7 9 4 9 9 9 9 4 9 9 9 9 9 9 4 9 9 9 5 7 9 9 9 9 4
4 4 4 4 4 4 4 4 4 4 4 4 4 4 4 4 4 4 4 4 4 4 4 4 4 4 4 4 4 4

